#######
#P   G#
# ### #
#     #
#######